h:9,w:8
++++++++
+   ++ +
  @ -  +
+   _  -
+  ++  +
+  -   +
+  +  _+
+     ++
++++++++
