h:9,w:8
++++++++
+   ++ +
    +  +
+   +  +
+  ++  +
+  +   +
+  +  ++
+     ++
++++++++
