h:14,w:15
+++++++++++++++
+ +     +  ---+
+ -    +++   ++
+ +   +++++   +
+ +   ----   o+
+ +   ++-++   +
+ + + ++-+   -+
+   + +--+   ++
+++++ +-++   ++
+   + +-++  --+
++  + +  +  +++
++  + +  +  --+
+++   ++++  +++
+++++++++++++++
